0000000000
0011111113
0012222220
0011111110
0000000010
0022222210
0000000010
0022222210
0411111110
0022222220