0000000000
0000000000
0000200000
0202020200
4111101113
0022111220
0002002200
0002222000
0000000000
0000000000
