0301111100
0121222100
0111002100
0022022100
0021111100
0021020200
0021111120
0000002120
0000002110
0000000040